
11 7
WWWWWWWWWWW
Wc0000C00GW
WWWBW0WWWWW
WaW0WWWWWWW
W0W0WWbWWWW
WS0A000WWWW
WWWWWWWWWWW