
7 7
WWWWWWW
W00000W
W00A00W
W00a00W
W00000W
WS0000W
WWWWWWW