
7 7
WWWWWWW
W00000W
WB0A00W
W00a00W
Wb0000W
WS0000W
WWWWWWW