
7 7
WWWWWWW
W0000GW
WWW0W0W
W0W0W0W
W0W0WWW
WS0000W
WWWWWWW